00000000000000000000000000000000000000000
00000000000000000000000000000000000000000
00000000000000000000000000000000000000000
00000000000000000000000000000000000000000
00000000000000000000000000000000000000000
00000000000000000000000000000000000000000
00000000000000000000000000000000000030000
22222222222222222220000221122000000220000
11111111111111111110000111111000000110000
11111111111111111110000111111000000110000
11111111111111111110000111111000000110000
11111111111111111110000111111000000110000
11111111111111111110000111111000000110000