00000000000000000000000000000000000000000
00000000000000000000000022200000000000000
00000000000000000000000000000000000000000
00000000000000000000000000000000000000000
00000000000000000000000000000000000000000
00000000000000000000000000000000000000000
00000000000000000000000000000000000030000
22222222222222222220000000000000000220000
11111111111111111110000000000000000110000
11111111111111111110000000000000000110000
11111111111111111110000000000000000110000
11111111111111111110000000000000000110000
11111111111111111110000000000000000110000