00000000000000000000000000000000000000000
00000000000000000000000000000000000000000
11111111111111111111111111111111111111111
11111111111111111111111111111111111111111
11111111111111111111111111111111111111111
11111111111111111111111111111111111111111
11111111111111111111111111111111111111111
11111111111111111111111111111111111111111
11111111111111111111111110000000000011111
11111111111111111111111110000000000011111
00000000000000000000000000000000000000000
00000000000000000000000000000000000000003
22222222222222222222222222200000000222222