000000000000000000000000000000
000000000000000000000000000000
000000000000000000000000000000
000000000000000000000000000000
000000022222000000000000000000
000000000000000000000000030000
000000000000000000000000022000
222222222222222222200002211220
111111111111111111100001111110
111111111111111111100001111110
111111111111111111100001111110
111111111111111111100001111110
111111111111111111100000000000