00000000000000000000000000000000000000000
00000000000000000000000000000000000000000
00000000000000000000000000000000000000000
00000000000000000000000000000000000000000
00000000000000000000000000000000000000000
00000000000000000000000000000000000000000
00000000000000000000000000000000000030000
22222211112222222220000221122000000220000
11111111111111111110000111111000000110000
11111111111111111110000111111000000110000
11111111111111111110000111111000000110000
11111111111111111110000111111000000110000
11111111110000000000000000000000000000000