000000000000000000000000000000
000000000000000000000000000000
000000000000000000000000000000
000000000000000000000000000000
000000000000000000000000000000
000000000000000000000000000000
000000000000000000000000003000
222222222222222222200002222220
111111111111111111100001111110
111111111111111111100001111110
111111111111111111100001111110
111111111111111111100001111110
111111111111111111100001111110