000000000000000000000000000000000000000000000000000000
000000000000000000000000000000000000000000000000000000
000000000000000000222222000000000000000000000000000000
000000000000000000111111000000000000000000000000000003
000000000000000000000000000000000000000000002222222222
000000000000000000000000000000000000000000001111111111
000000000000000000000000000000000000000000000000000000
000000220000000000000000000000000000000000000000000000
000000110000000000000000000000000000000000000000000000
000000000000000000000000000000000000000000000000000000
000000000000000000000000000000000000000000000000000000
000000000000000000000000000000000000000000000000000000
000000000000000000000000000000000000000000000000000000